##########
#A..#....#
#..##.#..#
#..#..#..#
#..#..#B.#
#..####..#
#C.......#
##########
